OOXOOOOOOOOOOOOO
OOXOXXXXXOOOOOOO
OOXXXOOOXOOOOOOO
OOOOOOOOXXXOOOOO
OOOOOOOOOOXOOOOO
OOOOOOOOOOXXXXOO
OOOOOOOOOOOOOXOO
OOOOOOOOOOOOOXOO
OOOOOOOOOOOXXXOO
OOOOOOOOOOOXOOOO
OOOOOOOOOOOXOOOO
OOOOOOOOXXXXOOOO
OOOOOOOOXOOOOOOO
OOOOOOOOXOOOOOOO
OOOOOXXXXOOOOOOO
OOOOOXOOOOOOOOOO