ONXNNNNNNNOOOOOO
ONXNXXXXXNOOOOOO
ONXXXNNNXNNNOOOO
ONNNNNONXXXNOOOO
OOOOOOONNNXNNNNO
OOOOOOOOONXXXXNO
OOOOOOOOONNNNXNO
OOOOOOOOOONNNXNO
OOOOOOOOOONXXXNO
OOOOOOOOOONXNNNO
OOOOOOONNNNXNOOO
OOOOOOONXXXXNOOO
OOOOOOONXNNNNOOO
OOOONNNNXNOOOOOO
OOOONXXXXNOOOOOO
OOOONXNNNNOOOOOO