OOXOOOOOOOOOOOOO
OOXNXXXXXOOOOOOO
OOXXXNNNXOOOOOOO
OOOOOOOOXXXOOOOO
OOOOOOOONNXOONNO
OOOOOOOOOOXXXXNO
OOOOOOOOOOOONXOO
OOOOOOOOOOOONXOO
OOOOOOOOOOOXXXOO
OOOOOOOOOOOXNOOO
OOOOOOOONNNXNOOO
OOOOOOOOXXXXOOOO
OOOOOOOOXNOOOOOO
OOOOOONNXNOOOOOO
OOOOOXXXXOOOOOOO
OOOOOXNOOOOOOOOO